0 0 0 1 0 0 0 2 3 2 2 2 2 3 2 4 5 4 5 4 5
0 . . . . . 0 2 . . . . . . 2 . . . . . 4
0 . . . . . 0 2 . . . . . . 2 . . . . . 5
0 . . x . . . . . . . . . . . . . . . . 4
0 . . . . . 0 2 . . . . . . 2 . . . . . 5
0 . . . . . 0 2 . . . . . . 2 . . . . . 4
0 0 0 1 0 0 0 2 3 2 2 2 2 3 2 4 5 4 5 4 5
