0 0 0 0 0 0 0 0 0 0 0 0 0
0 . . . . . . . . . . . 0
0 . 0 0 . . . . . 0 0 . 0
0 . 0 . . . . . . . 0 . 0
0 . . . . . . . . . . . 0
0 . . . . . . . . . . . 0
. . . . . . x . . . . . .
1 . . . . . . . . . . . 1
1 . . . . . . . . . . . 1
1 . 1 . . . . . . . 1 . 1
1 . 1 1 . . . . . 1 1 . 1
1 . . . . . . . . . . . 1
1 1 1 1 1 1 1 1 1 1 1 1 1
